Category,Content,1~3 Star,3~4 Star,4~5 Star,Total
Free,18+,7010,2290,310,9610
Free,15+,35634,42112,52012,129758
Free,10+,5027,3142,1124,9293
Free,7+,82810,36200,51525,170535
Free,All Age,125983,90233,20290,236506
Free,Unrated,28004,8002,1058,37064
Paid,18+,532,1145,3103,4780
Paid,15+,8568,20423,5201,34192
Paid,10+,2041,904,1129,4074
Paid,7+,11142,3624,5152,19918
Paid,All Age,14574,3563,1025,19162
Paid,Unrated,9478,1845,264,11587